R 600 480
F 0,100,30
C 100,130,130
EA textures/east.xpm
SO textures/south.xpm
WE textures/west.xpm
NO textures/north.xpm
S textures/barrel.xpm


11111111111111111111
12000000000000000001
1000000020000000S001
11111110000000000001
10000000000000000001
10000000200000000001
10000000000010000001
10000000000010020001
10000000000010000001
10000000000010000001
11111111111111111111
