R 3000 2000
F 0,100,30
C 100,130,130
EA Textures/east.xpm
SO Textures/south.xpm
WE Textures/west.xpm
NO Textures/north.xpm
S Textures/barrel.xpm


21111111111111111112
12000000000000000021
1000000000000000S001
11111110000000000001
10000000000000000001
10000000000000000001
10000000000010000001
10000000000010000001
10000000000010000001
12000000000010000021
21111111111111111112
